{
    "liste":[
        "01101mnmm1n0mnm",
        "nn0m1011m0m1nmm",
        "n010m1m001010nm",
        "00n0mmm010mm100",
        "0mn01010m0mnm01",
        "0mnm1m00m011m00",
        "0011m01mnm0m010",
        "m0nmm0m011m01mm",
        "m01001m0m001mmn",
        "m01mn0m0n01mmnm",
        "mn0m000n0m0m00m",
        "010mm0mn01n01mn",
        "1mmmm0nm0010mmm",
        "010110010mm1mmm",
        "00mmm10100m0100"
    ]
}